██████████████████████████████████
████          ██              ████
████  ██████  ██████████  ██  ████
████  ██      ██          ██  ████
████  ██  ██████  ██████████  ████
      ██          ██  ██      ████
████████████████████  ██  ██      
████                  ██      ████
████  ██████  ██████████████  ████
████      ██              ██  ████
████████  ██████████  ██  ██  ████
████  ██      ██      ██  ██  ████
████  ██████  ██  ██████████  ████
████  ██      ██  ██          ████
████  ██  ██████  ██  ████████████
████          ██              ████
██████████████████████████████████
