██████████████████████████████████████████████████████████████████████
████                  ██              ██                          ████
████  ██████████████  ██████  ██████  ██  ██████████████████████  ████
████  ██      ██      ██      ██  ██  ██  ██              ██      ████
████  ██  ██  ██████  ██  ██████  ██  ██  ██  ██████████  ██  ██  ████
████  ██  ██      ██      ██          ██  ██      ██          ██  ████
████  ██  ██████  ██████████  ██████████  ██████  ██  ████████████████
████      ██  ██  ██                  ██  ██      ██      ██      ████
████  ██████  ██  ██  ██████████  ██████  ██  ██████████████  ██  ████
████          ██  ██  ██      ██  ██      ██      ██          ██  ████
████████████  ██  ██████  ██  ██████  ██████████  ██  ██████████  ████
████      ██  ██      ██  ██              ██      ██      ██      ████
████████  ██  ██████  ██  ██████████████  ██  ██████████  ██  ████████
████      ██  ██  ██          ██      ██  ██  ██          ██      ████
████  ██████  ██  ██████████████  ██  ██████  ██  ██████████████  ████
████      ██          ██          ██      ██          ██              
████  ██  ██████████  ██  ██████████████  ██████████████  ██████  ████
████  ██          ██  ██          ██  ██          ██      ██      ████
████  ██  ██████  ██  ██████████  ██  ██████████  ██  ██████  ████████
████  ██  ██      ██          ██  ██          ██      ██      ██  ████
████  ██  ██████  ██  ██████████  ██  ██████  ██████████  ██████  ████
████  ██      ██  ██  ██      ██  ██  ██          ██  ██          ████
████  ██████  ██████  ██  ██  ██  ██  ██████████  ██  ██████████  ████
████      ██          ██  ██      ██  ██      ██              ██  ████
████████  ██████████████  ██████████  ██  ██  ██████████████  ██  ████
      ██              ██          ██      ██  ██          ██  ██  ████
████  ██████████████  ██████████  ██████████  ██  ██████  ██████  ████
████          ██      ██      ██      ██      ██      ██      ██  ████
████████████  ██  ██████  ██  ██████  ██  ██  ██████  ██████  ██  ████
████      ██  ██      ██  ██          ██  ██  ██      ██  ██      ████
████████  ██  ██████████  ██████████████  ██████  ██████  ████████████
████      ██          ██  ██              ██      ██              ████
████  ██████████████  ██  ██  ██████  ██████  ██████████████  ██  ████
████                      ██      ██                          ██  ████
██████████████████████████████████████████████████████████████████████
