██████████████████████████████████████████████████████████████████████
          ██              ██                  ██                  ████
████████  ██  ██  ██████  ██████████  ██  ██████  ██████  ████████████
████  ██  ██  ██  ██  ██          ██  ██          ██      ██      ████
████  ██  ██  ██  ██  ██████████  ██████████████████  ██████  ██  ████
████  ██  ██  ██  ██                              ██          ██  ████
████  ██  ██  ██  ██████████████████████████████  ██  ██████████  ████
████      ██  ██              ██              ██  ██      ██      ████
████  ██████  ██████████████  ██  ██████  ██████  ██████████  ██  ████
████  ██          ██      ██  ██  ██  ██          ██      ██  ██  ████
████  ██████████████  ██  ██  ██  ██  ██████████████  ██  ██  ████████
████      ██      ██  ██      ██      ██  ██          ██  ██      ████
████████  ██  ██  ██  ██████████████  ██  ██  ██████  ██  ██████  ████
████      ██  ██      ██          ██  ██          ██  ██              
████  ██████  ██████████  ██████  ██  ██████████  ██  ██████████  ████
████      ██                  ██  ██          ██  ██  ██      ██  ████
████████  ██████████████████  ██  ██████████  ██  ██  ██████  ██  ████
████  ██          ██      ██  ██  ██      ██  ██  ██      ██      ████
████  ██████████  ██  ██  ██████  ██  ██  ██  ██  ██████  ████████████
████          ██      ██          ██  ██  ██  ██  ██  ██          ████
████  ██████  ██████████████████████  ██████  ██  ██  ██  ██████  ████
████  ██  ██                          ██      ██      ██  ██      ████
████  ██  ██████████████████  ██████████  ██████████  ██████  ██  ████
████      ██      ██      ██          ██  ██          ██      ██  ████
████████  ██  ██████  ██  ██  ██████  ██  ██  ██████████  ██████  ████
████          ██      ██  ██      ██  ██  ██          ██      ██  ████
████  ██████████  ██████  ██████████  ██  ██████████████████  ██  ████
████      ██      ██  ██              ██  ██      ██          ██  ████
████████  ██  ██████  ██████  ██████████  ██  ██  ██  ██████████  ████
████  ██  ██      ██          ██      ██      ██      ██      ██  ████
████  ██  ██████  ██████████  ██  ██  ██████████████████  ██████  ████
████  ██      ██          ██  ██  ██  ██          ██              ████
████  ██████  ██████████  ██████  ██  ██  ██████  ██  ████████████████
████                  ██          ██          ██                  ████
██████████████████████████████████████████████████████████████████████
